NO ./assets/cat/albanie.xpm
SO ./assets/cat/albanie.xpm
WE ./assets/cat/albanie.xpm
EA ./assets/cat/albanie.xpm

F 208,171,147
C 155,202,255

111111111111111111111111111111111111111111111111111111111111
10000000000000X000000000000000000000000000000000000000000001
10000000000X0X0000000000000000000000000000000000X00000000001
10000X0000000X00000000000XXXXXX00000000000000000000000000001
100000X0000000000000000000000000000000000000000000000000000011111
1001DD10000111D00001111000011110001111000D1D1D0000111011100001
10010001000100010001000100010XXX00100000010X0D0001XXXDXXX10001
100100X1000100XD000DX0001X01000000D000000D00010001XXX0XXXD0001
10011111000111100001111000011D000011D1000111DD0001000X00010001
1001000100010X01000DX001000D0X00000001000D000D0000100X00100001
10010X01000D0001000100010001000000XX01000D0X010000010X0100000111111111111111
100100010001000100011110000111100011D10001000D0000001X1000000111111111X11111
1000000000000000000000000000000000000000000000000000010000000011111111D11111111111111111111111111111111111111
100000000000XXXXXXXX00000000000000000000N000000000000000000000000XXX000000000000000001
10000000000X000000000000000000X0000000000000000000000000000000000XXX000000000000000001
10X00000000000000000XXXXX0000000000000000000000000000000000000000XXX00000000000000XXX1
1111111111111111111111111111111111111111111111111111111111111111111111111111111111111111111