
F 155,202,243
C 208,171,147

NO ./assets/cat/albanie.xpm
SO ./assets/g.xpm
WE ./assets/b.xpm
EA ./assets/y.xpm

1111111111111
1000000000111
1111D11111111
1011001000111
10010000EX001
1111111111111
