
F 155,202,243
C 208,171,147
NO ./assets/cat/albanie.xpm

SO ./assets/g.xpm
WE ./assets/b.xpm
EA ./assets/y.xpm

1111111111111
100X000000001
1000X00000111
1011001001111
10010000N0X01
100001D100001
111111D111111
1XXXXXXXXXXX1
1111111111111